{
    "title_size": 48,
    "cols": 20,
    "rows": 15,
    "grid": [
        [0,0,0,0,0,0,0,0,0,0,0,0,0,0,0,0,0,0,0,0],
        [0,0,0,0,0,4,0,0,0,0,4,0,0,0,0,0,0,0,0,0],
        [0,0,0,0,0,0,0,4,0,0,0,0,0,0,0,4,0,0,0,0],
        [2,1,1,1,1,1,1,1,1,1,1,1,1,0,0,0,0,0,0,0],
        [0,0,0,0,0,0,0,0,0,0,0,0,1,0,0,0,0,0,0,0],
        [0,4,0,0,0,0,0,4,0,0,0,0,1,0,0,0,0,0,4,0],
        [0,0,0,4,0,0,0,0,0,0,0,0,1,0,0,0,0,0,0,0],
        [0,0,0,0,0,0,0,0,0,0,4,0,1,1,1,1,1,1,1,3],
        [0,0,0,0,0,0,0,0,0,0,0,0,0,0,0,0,0,0,0,0],
        [0,0,0,0,0,0,0,0,0,0,0,0,0,0,4,0,0,0,0,0],
        [0,0,0,0,0,0,0,0,0,0,0,0,0,0,0,0,0,0,4,0],
        [0,0,0,0,0,0,0,0,0,0,0,0,0,0,0,0,0,0,0,0],
        [0,0,0,0,0,0,0,0,0,0,0,0,0,0,0,0,0,0,0,0],
        [0,0,0,0,0,0,0,0,0,0,0,0,0,0,0,0,0,0,0,0],
        [0,0,0,0,0,0,0,0,0,0,0,0,0,0,0,0,0,0,0,0]
    ]
}